22222222222222222222
00000012344321000000
11111111111111111111
32221111222211112223
40404040044004040404
11111111111111111111
11111111111111111111
12344321000012344321
01010101011010101010
22222222222222222222
