12223322211222332221
01033112ACCA21133010
C33101A044440A10133C
14222222211222222241
00000000000000000000
0000C3321AA1233C0000
11141114111141114111
422202220AA022202224
31133113311331133113
00000000000000000000