41112340400404321114
1200034C3AA3C4300021
33331442122124413333
00000000000000000000
02322121433412122320
2222A121ACCA121A2222
01234CC14AA41CC43210
13440012333321004431
44244324211242344244
1002AA34100143AA2001
