33000000000000000033
43300000000000000334
40330000000000003304
40433333333333333404
40404040400404040404
222A222A2222A222A222
AAA2AAA2AAAA2AAA2AAA
22444222222222244422
010C010101101010C010
11141111111111114111

This is the level used in the main menu.
