00000000000000000000
00000000000000000000
00000000000000000000
33333333333333333333
42224242444424242424
33333321212333333333
14441414144141414441
14141414144141414141
34443333333333334443
23232323233232323232
