33222333444433322233
12222223343322222221
00000000000000000000
22223333444433332222
00000000000000000000
31231231233213213213
12121233444433121212
31113111111311131113
41112333444433321114
40211111333311111204
