33332223423342113442
22222333234232001123
11114222434333222111
32412343212332122212
32222221111111100214
22231132234321232132
00000111123232143212
11232123442221222111
11123000031234323411
22223333232323111231
