00122234CCCC43222100
4212121A2112A1212124
0AAA043233332340AAA0
C411123141141321114C
00000000000000000000
000000000AA000000000
44444123122132144444
12113000A33A00031121
000322123CC321223000
32114443200234441123
