00000000000000000000
00000000000000000000
00000000000000000000
33333333333333333333
42224242444424242424
33C33333211233333C33
14441414144141414441
1C1414141441414141C1
34443A3A3AA3A3A34443
A3A3A3A3A33A3A3A3A3A
