44444444422444444444
44444444222244444444
00333333211233333300
44444441111114444444
00003213333331230000
33333333311333333333
000000000AA000000000
004444111CC111444400
33333122222222133333
00000000000000000000
