33000000000000000033
43300000000000000334
40330000000000003304
40433333333333333404
40404040400404040404
222A222A2222A222A222
11111111111111111111
12344321000012344321
01010101011010101010
11111111111111111111

This is the level used in the main menu.
