44444444222244444444
00000000000000000000
44444422111122444444
333A333C4444333A333C
44442121CAAC12124444
00000000000000000000
033343334AA433343330
1114321A4334A1234111
03322222111122222330
00000000000000000000
