00000000000000000000
11112334344343321111
22222222AAAA22222222
04041111311311114040
0000C0000AA0000C0000
33311421244212411333
11243A3AA00AA3A34211
00000000000000000000
33333C33100133C33333
AAA21223400432212AAA
