00000000000000000000
00000000000000000000
00000000000000000000
33333333333333333333
42424242444424242424
33333333333333333333
14141414144141414141
14141414144141414141
33333333333333333333
23232323233232323232
