44412243332210121121
42213033222011232101
00032112333223432234
11223444220003333431
22224333352123336622
00000000022223312242
11110002321232343532
42433334223300042312
12344321333223321341
12221221111222112212
