33222333444433322233
12222223344332222221
0AA00000000000000AA0
22223333444433332222
000000000AA000000000
312312312CC213213213
12121233444433121212
31113111111311131113
41112333444433321114
402111113AA311111204
